{
    "height": 8,
    "width": 8,
    "units": [0, 0, 0, 0, 0, 0, 0, 0,
              1, 0, 3, 0, 0, 3, 0, 2,
              0, 1, 0, 3, 3, 0, 2, 0,
              1, 0, 3, 0, 0, 0, 0, 2,
              1, 0, 0, 0, 0, 3, 0, 2,
              0, 1, 0, 3, 3, 0, 2, 0,
              1, 0, 3, 0, 0, 3, 0, 2,
              0, 0, 0, 0, 0, 0, 0, 0],
    "mapOffsetX": 32,
    "mapOffsetY": 32
}